1,Example Options,false,SAVED,1,{[]},
{[,0,1,2,3,4,5,6,7,8,9]
[0,11,11,2,11,11,-1,11,11,11,11]
[1,11,-1,11,11,11,11,11,7,11,11]
[2,11,1,11,11,-1,11,11,11,11,11]
[3,11,11,11,11,4,11,11,11,11,-1]
[4,11,-1,11,11,11,5,11,11,11,11]
[5,11,11,11,11,-1,11,6,11,11,11]
[6,-1,11,11,11,11,11,6,11,11,11]
[7,11,11,11,11,11,-1,11,11,11,9]
[8,11,11,-1,11,11,5,11,11,11,11]
[9,11,1,11,11,11,11,11,-1,11,11]}